Level 2
11111111111111111001
12222222222222222001
10000000000000000001
10011111111100000001
10012222221100111111
10010000002200122222
10010000000000100000
10020001111111100111
10000001222221100211
10011111000001100011
10011111001001110021
10022222001002220001
10000000001000000001
11111111111111111111
18 1
00000000000000000000
00000000000000000000
0T131022101100101100
00000000000000112000
00000000000000000000
00000001310000000009
00000001310200010339
00000000000000001000
00000000000000001000
01200000001000022000
02100000110110000000
00000000000000000000
00033333000002220000
00000000000000000000
level3
