Level 4
11111111111111111111
11112222222222222111
11110000000000000111
11110011111100100111
11110022221100100211
12210000001100110011
10011111002100110021
10022221000100211001
10000001100100011001
11111001100100011001
11111001100110011001
12222002200110022002
10000000000110000000
10011111111111111111
2 14
00000000000000000000
00000000000000000000
00003333060600000000
00003300000044000000
00000000000000066000
00000000000033000000
0T100000440033000000
01100000032011000780
03330400012033000330
00000310011000800660
00000000000003300660
00000440022001100009
00000003333000066009
00000000000000000000
level5
