Level 1
11111111111111111111
22211111122222222221
00011111100000000001
10011222200111001001
10011000000111001001
10011001111111001001
10011002111222001001
10011000111000001001
10011100111000001001
10011100111001111001
10022200222001112001
10000000000001110001
10000000000001111001
11111111111111111001
1 3
00000000000000000000
00000000000000000000
00000000002000001000
01100000011000000220
0220022001T000000000
02200110000000000110
03300000000000110000
00000000000033300110
00000022000033300000
00000011000110000220
00000000000000000220
00000000000000000000
00000000000000000000
00000000000000000990
level2
