Level 3
10011111111111111111
10022221112222222221
10000002220000000001
11000000000011100001
11111111111111111001
22222212222211111001
00000010000022112001
10010011110000110001
10010022211100110011
10010000011100110011
10011100011100110011
10022110022200220021
10000110000000000001
11111111111111111111
1 7
09900000000000000000
00000000000000000000
00311000000000111000
00011005350000001000
00000000000000000000
00000000000000000000
0000000T112000000000
01104400002220000000
01100000000000001100
03300011100000000800
01100013100000007800
00000003000044000000
0221L000000333300000
00000000000000000000
level4
