Level 6
11111111111111111111
12221221222222222221
10002001000000000001
10000002000000000001
20001000001111100111
00001000011222200221
11111001112000000001
12221001220001111111
10001001000012222221
10001001000110000001
11001001000220011001
12002001000000012001
10000001000000010001
11111111111111110011
1 6
00000000000000000000
00000000000000000000
00040000003333311000
00434000004444455000
00040004200000000000
00000004100000044000
00000000000005500000
00000780000000000000
0T220000733000000000
07110110011000434000
00110110711001000780
00000000010340000000
00120200740550000000
00000000000000009900
level7
