Level 7
11111111111111110011
12222222222222220021
10000000000000000001
10011111111111111111
10022222222222222221
10000000000000000001
11111111111111111001
12222222222222222001
10000000000000000001
10011111111111100111
10022112222221100111
10000220000002200222
11100000011000000000
11111111111111111111
17 1
00000000000000000000
00000000000000000000
01104040110404040000
01100000000000000000
07000000000000000000
00040405502220110400
00000000000000000080
00000000000000000080
04334030305434043400
07400000000000004000
0T000000000000078000
00004003333040000009
00043340100433405509
00000000000000000000
level8
