Level 5
11111111111111111111
12222222222222222221
10000000000000000001
11100110011001111111
12200220022002222222
10000000000000000000
10011001100110011001
10022002200220022001
10000000000000000001
11100110011001111111
12200220022002222221
20000000000000000001
00011001100110011001
11111111111111111111
1 13
00000000000000000000
00000000000000000000
00001331000011020T80
00000000000780000000
00000001100000000009
00400401100000043409
00300300078007800010
00300300000000000110
00400401100000333330
00000001100780000000
00000000000000000000
00000434055005500380
000000000000000007L0
00000000000000000000
level6
