Level 8
11111111111111111111
12222212222212222221
10000010000010000001
10010010010020010001
10010010010000010001
10010010010010010001
10010010010010010001
10010010010010010001
10010010010010010001
10010010010010010001
10010010010010010001
20010020010020010001
00010000010000010001
11111111111111111111
1 13
00000000000000000000
00000000000000000000
00434000434004333400
04404404404400404000
00000000000000000000
07807805503303307480
00000000003303304340
04404404405505507480
00000003300000003430
07807803307807807080
00000004407807800000
04404400000000000C00
000004340004T4000000
00000000000000000000
gameover
